NO ./textures/banner.xpm
SO ./textures/eagle.xpm
WE ./textures/hitler.xpm
EA ./textures/grey.xpm

F 80,80,80
C 30,30,30

111111111111111111111111111111111111111111111
111111111111111111111111111111111111111111111
100000000000011100000000000011000000000000011
100000000000000000000000000011000000000000011
100000000000011100000000000011000000000000011
111111001111111100000000000011000000000000011
100000000000000000000000000011111111100111111
10000000000001110000W001000000000000000011111
100000000000011100000000000011100000000000011
100000000000011111111110000011100000000000011
100000000000011100000000000011100000000000011
100000000000000000000000000011100000000000011
111111111111111111111111111111111111111111111
