NO ./textures/banner.xpm
SO ./textures/eagle.xpm
WE ./textures/hitler.xpm
EA ./textures/grey.xpm
F 10,100,0
C 225,30,0

111111111111111111111111111111111111111111111
111111111111111111111111111111111111111111111
100000000000011100000000000011100000000000011
100000000000011100000000000011100000000000011
100000000000011100000S00000011100000000000011
100000000000011100000000000011100000000000011
100000000000111000000000011100000000001111111
111111111111111111111111111111111111111111111
